A	AH
A(2)	EY
BATTLE	B AE T AH L
BREAK	B R EY K
BROWSER	B R AW Z ER
CLOSE	K L OW S
CLOSE(2)	K L OW Z
COMMAND	K AH M AE N D
FILE	F AY L
JARVIS	JH AA R V AH S
JARVIS(2)	JH AA R V IH S
MANAGER	M AE N AH JH ER
MANAGER(2)	M AE N IH JH ER
NET	N EH T
OPEN	OW P AH N
PROGRAM	P R OW G R AE M
PROMPT	P R AA M P T
STEAM	S T IY M
TAKE	T EY K
TERMINATE	T ER M AH N EY T